    1111111111111111111111111111
    1000000000110000000000000001
11111011000001110000000000000001
10010000000000000000000000011111
1111111110110000011100000001
1000000000110000011100110001
1111011111111101110000010001
1111011111111101111010010001
1100000011010101110000010001
1000000000000000110000010001
1000000000000000111010000001
110000011101010111101110N011
11110111 1110101 10111101001
11111111 1111111 11111111111